postpone | vt. 推迟，延缓
descend | vt. vi. 下来，下降
intimate | adj. 亲密的，幽静舒适的
pinch | vt. 捏，掐，行窃，逮捕
forthcoming | adj. 即将到来的
ashore | adv. 在岸上，向岸上
diagnose | vt. vi. 诊断（病症）
bait | vt. 给（鱼饵或陷阱）上诱饵
inertia | n. 惯性
penetrate | vt. vi. 穿过，进入，渗透（组织、团体）
plain | adj. 平凡的 | adv. 完全地，简直
distill | vt. 蒸馏，提炼（信息）
revolve | vi. 围绕，以...为中心
blunder | n. 愚蠢的错误，疏忽，失误
obsolete | adj. 淘汰的，过时的，废弃的
incidence | n. 发生率
compel | vt. 强迫，逼迫
assassinate | vt. （尤以政治目的的）暗杀，行刺
advocate | vt. 提倡，主张 | n. 拥护者，提倡者
controversy | n. 争论，争议
procession | n. 队伍，行列，游行
contradict | vt. 相矛盾
extravagant | adj. 奢侈的，铺张浪费的
resilient | adj. 坚韧的，有适应力的
compliment | n. 称赞，赞美的话
compensate | vi. 弥补，补偿 | vt. 给...补偿
generalize | vi. 概括，归纳
convene | vt. vi. 召集，召开，集合
staple | n. 支柱产品
protest | n. 抗议，反对 | vt. 申辩，申明
graceful | adj. 优美的，优雅的
erect | vt. 建造
tempo | n. （乐曲的）节奏，（发展的）速度
sprout | vt. vi. 发芽，抽芽，长出（毛发等）
impetus | n. 动力，促进，刺激
shipment | n. 运输，运送，（一批）运输的货物
withhold | vt. 拒绝给予，扣留，隐瞒
analysis | n. 分析，化验
sphere | n. 范围，领域
intelligible | adj. 可理解的，明白易懂的
overlap | vt. vi. （与...）重叠
executive | n. 经理，主管 | adj. 执行的，行政的，高级的
strenuous | adj. 竭尽全力的
formula | n. 方案
competent | adj. 能胜任的
grip | n. 紧握，紧抓，掌握，控制 | vt. 对...具有强烈影响
grasp | vt. 抓紧，理解，急忙抓住（机会） | n. 理解（力）
curb | vt. 控制，限制，抑制 | n. 控制，限制，抑制
amid | prep. 在...过程中
inhabitant | n. 居民，栖居的动物
gauge | n. 标准
strap | n. 带子 | vt. 用带子系（或绑）
cruise | vi. 以平稳的速度行驶
whereas | conj. 然而，但是
optical | adj. 视力的，光的，光学的
distress | vt. 使忧虑，使悲伤，使苦恼
migrate | vt. 迁徙，移居
await | vt. 等待，期待
lend | vt. 借给，借出
imperial | adj. 帝国的，皇帝的，英制的
haste | n. 匆忙，仓促
align | vt. 使一致
preclude | vt. 阻止，妨碍，排除
manuscript | n. 手稿，原稿，底稿
summit | n. 山顶，顶峰
sheet | n. 一张
audience | n. 观众，听众，读者
cord | n. 粗线，细绳，电源线，灯芯绒裤
discretion | n. 自主决定权，谨慎，慎重
tackle | vt. 处理（难题）
presume | vt. vi. 推测，猜测
alienate | vt. 使疏远，使不友好，使格格不入
plea | n. 恳求
acclaim | vt. 赞扬，公开称赞 | n. 赞扬，公开称赞
mediate | vt. vi. 调停，调解
discriminate | vi. 歧视，区别对待
ambiguous | adj. 模棱两可的，含糊不清的
brisk | adj. 麻利的
bid | vi. 努力争取 | n. 出价，投标，努力争取
affiliate | vt. vi. （使）隶属于，（使）紧密联系 | n. 分支机构，附属组织，分公司
impulse | n. 冲动，推动力
sketch | n. 素描，草图，简报，概述
delicate | adj. 微妙的
nursery | n. 托儿所，婴儿室
revolutionary | adj. 革命的，革命性的，突破性的
thrust | vt. vi. 猛推，挤 | n. 猛推，刺，戳
withstand | vt. 经受住，承受，顶住
chorus | n. 齐声
dialect | n. 方言，地方话
reel | n. 卷轴 | vi. 踉跄，感到震惊
clockwise | adj. adv. 按顺时针方向
curriculum | n. 课程
persuade | vt. 劝说，说服，使说服，使相信
heighten | vt. vi. （使）加强，（使）增加
quota | n. 限额，配额，定额，指标
troublesome | adj. 令人烦恼的，困难的
interim | adj. 暂时的，过渡的
sore | adj. 疼痛的，酸痛的 | n. 痛处，伤处
intrude | vi. 打扰，干涉
reckon | vt. 看作，看待，估算，估计
applaud | vt. 称赞，赞许
flap | vt. vi. 拍打（翅膀） | n. 忧虑
peel | vt. 剥皮，去皮
audit | n. 审计
transit | n. 运输，交通系统
obedience | n. 服从，驯服
tedious | adj. 冗长的，乏味的
stake | n. 重大利益
surgeon | n. 外科医生
insight | n. 深刻见解，洞悉
drip | vi. （液体）滴下
patrol | vt. vi. 巡逻，巡查
implicit | adj. 含蓄的，不言明的，内含的
preside | vi. 主持，负责（会议等）
manifest | vt. 显现，表明
culprit | n. 问题的起因
jurisdiction | n. 司法权，管辖权，管辖区域
vague | adj. 含糊的，笼统的
diversion | n. 转向，转移，令人分心的事物
levy | n. 征收额，（尤指）税款 | vt. 征收，征（税）
confine | vt. 限制，使...局限于，监禁，关押
incentive | n. 激励，动力，奖励
proclaim | vt. 宣布，声明，表明，显示
frustrate | vt. 使灰心，使沮丧，阻止，挫败
supervise | vt. vi. 监督，管理，指导，主管
presumably | adv. 很可能，据推测
certificate | n. 证明，证书
integrate | vt. vi. （使）合并，（使）融入群体
despise | vt. 鄙视，藐视
tumble | vt. vi. （使）跌倒，滚落
possess | vt. 拥有，具有，具备
accumulate | vt. 积累，积聚
ample | adj. 大量的，足够的
remedy | n. 解决方法，药品，疗法 | vt. 纠正，补救
ingenious | adj. 精巧的，巧妙的，善于创造的
indignation | n. 愤慨，愤怒，义愤
comprise | vt. 包括，由...组成
compress | vt. vi. （使）压紧，压缩
exploit | vt. 利用
counsel | n. 辩护律师 | vt. 建议，劝告，提供专业咨询
perish | vi. 死亡
lapse | n. 疏忽，过失
loom | vi. 逐渐逼近 | n. 织布机
evacuate | vt. vi. （使）撤离，疏散，转移
awe | n. 敬畏，惊叹
petrol | n. 汽油
tense | n. （动词的）时态
homogeneous | adj. 由同种族人组成的
cluster | n. 群，组，串，簇，堆
quarantine | n. （为防传染的）隔离期
violet | n. 紫罗兰 | adj. 紫罗兰色的
preach | vt. vi. 讲道，布道，宣传，鼓吹
convention | n. 习俗，惯例，大会，公约，规定
conference | n. 会议
assemble | vt. vi. （使）集合，（使）聚集 | vt. 组装，装配
cease | vt. vi. （使）停止
mandate | n. 授权，授权令，命令 | vt. 强制执行
denote | vt. 表示，意指
obsession | n. 痴迷，着魔
protocol | n. 礼节，礼仪
conscious | adj. 意识到的，有意的 | suff. 注重...的，有...意识的
surplus | n. 过剩，过剩量，盈余，顺差 | adj. 过剩的，剩余的
magnify | vt. 放大，夸大
designate | vt. 指定，选定
fling | vt. 扔，掷 | n. 一时的放纵
probe | vt. vi. 追问，探究，打探
worship | vt. vi. 敬奉（神）
derive | vt. 从...中获得 | vi. 起源于，来自
auxiliary | adj. 辅助的
compose | vt. 组成 | vt. vi. 作（曲），写（信、诗等）
tow | vt. 牵引，拖，拉（车或船）
vulnerable | adj. 脆弱的，易受伤害的
prime | adj. 首要的 | n. 盛年，鼎盛时期 | vt. 事先指点
assault | n. 攻击，袭击
firm | n. 公司，商行，事务所 | adj. 坚定的
cater | vi. 满足，迎合
exert | vt. 施加，运用，行使
assembly | n. 集会
successor | n. 接任者，继承者
confidential | adj. 机密的
integrity | n. 正直，诚实，完整，完全
humble | adj. 谦逊的，卑微的，不起眼的
disperse | vt. vi. （使）扩散，（使）展开
conservation | n. 保护，节约，保存
applicable | adj. 适合的，适用的
conduct | vt. 实施，执行，传导，引导 | n. 行为，举止，实施方法
statute | n. 法令，法规
assistance | n. 帮助，援助，支持
verbal | adj. 口头的，言辞的
attain | vt. 获得，赢得，达到
ponder | vt. vi. 沉思，考虑
tram | n. 有轨电车
feeble | adj. 无效的，牵强的
lumber | n. 木材
lecture | n. 讲座，讲课 | vi. 开讲座，讲授 | vt. 训诫，教训
hardware | n. 重武器
toil | vi. 苦干，辛勤劳作
biography | n. 人物传记，传记文学
scold | vt. vi. 训斥，责骂
net | n. 网，互联网 | adj. 净赚的
respective | adj. 分别的，各自的
decorate | vt. 装饰
suppose | vt. vi. 认为，猜想 | vt. 假定，假设
triumph | n. 成功，胜利，胜利的喜悦 | vi. 成功，获胜
conform | vi. 遵守，相一致
sensible | adj. 明智的
fierce | adj. 凶猛的，激烈的
toast | vt. vi. 烤（尤指面包），把...烤的焦黄 | vt. 为...举杯敬酒
petition | n. 请愿书
manipulate | vt. （暗中）操纵，（熟练地）操作
hinder | vt. 阻碍，妨碍，阻止
conceive | vt. vi. 想象，想出，构想，怀孕
detain | vt. 拘留，扣押，耽搁
estimate | vt. 估计，估算，估价 | n. 估计，估算，估价
thrift | n. 节约，节俭
ignorant | adj. 无知的，愚昧的，不知情的
elicit | vt. 引出，诱出，套出
gamble | vt. vi. 赌博
intensive | adj. 密集的，强化的
sufficient | adj. 充足的，足够的
relativity | n. 相对论，相对性
whirl | vt. vi. （使）旋转，（使）打转
influential | adj. 有影响力的，有权势的 | n. 有影响力的人
indignant | adj. 愤慨的，愤怒的
substitute | vt. vi. 替换，取代 | n. 代替者，代替物
refute | vt. 反驳，否认...的正确性
anchor | n. 主持人 | vt. 使固定
therapy | n. 疗法，治疗，心理治疗
culminate | vi. 以...告终，达到...的顶点
fruitful | adj. 富有成效的
plausible | adj. （说法）貌似合理的
compromise | n. 折中，妥协 | vt. 危及，有损
amuse | vt. 逗笑，逗乐
brace | n. 支架，背带
prohibit | vt. 禁止
means | n. 方法，途径
elementary | adj. 初级的
overturn | vt. 推翻（判决等）
turnover | n. 人员流动率
latter | adj. 后者的，后期的
wit | n. 机智风趣的人
perpetual | adj. 不间断的，长久的
comprehend | vt. vi. 理解，领悟
aesthetic | adj. 美学的
plead | vt. vi. 恳求，央求
amend | vt. 修订（法律、文件等）
virtual | adj. 几乎...的，实际上的，虚拟的
scramble | vi. 攀爬 | n. 争抢，抢夺
transition | n. 过度，转变
faithful | adj. 忠贞的，如实的
vocal | adj. 直言不讳的
humorous | adj. 滑稽有趣的，幽默的
charity | n. 慈善机构
tangible | adj. 实际的，真实的，有形的
locomotive | n. 机车，火车头 | adj. 移动的
plaster | n. 灰泥
regime | n. 政权，政体，组织方法
campaign | n. （社会、政治）运动，活动 | vt. vi. 发起运动，开展活动
integral | adj. 必不可少的
misery | n. 痛苦
confer | vt. 授予，赋予
accessory | n. 配件，附属品
emphasize | vt. 强调，重视
affirm | vt. 证实，确认，断言，申明
fancy | adj. 花哨的，奢华的 | vt. 想要，想做 | n. 想象
deter | vt. vi. 威慑，制止，阻止
questionnaire | n. 调查问卷，调查表
construct | vt. 建造，修建，组成，构成 | n. 构想，概念，观念
divert | vt. 使转向，使分心，改变用途
facet | n. 部分，方面
console | vt. 安慰，抚慰 | n. 控制台，仪表盘
revenue | n. 收入，财政收入，税收
outrage | n. 愤怒，愤慨 | vt. 使震怒，激怒
indicative | adj. 表明的，表示的，暗示的
passive | adj. 被动的，消极的
diverse | adj. 多样的，形形色色的
behave | vi. 表现 | vt. vi. 举止得体，有礼貌
reflect | vt. 反映 | vt. vi. 认真思考
stun | vt. 使震惊，使昏迷，使印象深刻
aggregate | n. 总数，集合体 | adj. 总数的，合计的 | vt. 总计达到，使聚集
confess | vt. vi. 承认
concept | n. 概念，想法
enterprise | n. 企业，项目，规划
obligation | n. 义务，责任
setting | n. 环境，背景，设置，档
configuration | n. 配置
embed | vt. 使...嵌入
pursuit | n. 追求，追赶，爱好，消遣
federation | n. 联盟，联合会
turbulent | adj. 动荡的，混乱的
commodity | n. 商品，货物
lateral | adj. 侧面的，横向的，侧向的
abolish | vt. 废止，取消
bargain | n. 便宜货，协议，协定 | vi. 讨价还价，洽谈，谈条件
radiant | adj. 容光焕发的
revelation | n. 被揭示的真相
aggravate | vt. 加重，使恶化
underlie | vt. 构成...的基础，作为...的原因
deliberate | adj. 故意的
stock | n. 库存，储备物，股票 | vt. 贮存，贮备
knit | n. 编织的衣服，针织衫
identity | n. 身份，本体，特性，个性
surpass | n. 超过，胜过
massive | adj. 巨大的，严重的
ingredient | n. 配料，成分，因素
mutual | adj. 相互的，彼此的，共有的
literally | adv. 确实地
symposium | n. 专题讨论会，研讨会
mortgage | n. 房屋抵押贷款，按揭
pavement | n. 人行道
pave | vt. 铺，筑（路或地面）
novelty | n. 新奇
machinery | n. （统称）机器
batch | n. 一批，一组
provoke | vt. 激起，引起，挑衅，煽动
symphony | n. 交响乐，交响曲
fuse | n. 保险丝 | vt. vi. （使）融合，熔接
heritage | n. （国家或社会的）遗产，传统
torture | vt. 使痛苦，使受煎熬
epidemic | n. 流行病，泛滥，猖獗 | adj. 泛滥的，猖獗的
enlighten | vt. 启发，开导，教化
accomplish | vt. 完成，达成
comprehension | n. 理解力
context | n. 背景，环境，上下文，语境
invoke | vt. 援引（法律）
stance | n. 态度，立场
definite | adj. 确定的，清楚的
embody | vt. 使具体化，体现
wage | n. 工资，工钱 | vt. 发动，进行（运动和战争）
energetic | adj. （人）充满活力的，（活动）剧烈的
publicity | n. （媒体的）关注，报道
contrary | adj. 相对立的，相反的
conductor | n. 指挥
proximate | adj. （原因）直接的，最接近的
flourish | vi. 繁荣，兴旺，茁壮成长
treaty | n. 条约，协定
unify | vt. vi. 使统一，使成一体
premier | n. 总理，首相
span | n. 持续时间，范围 | vt. 持续，贯穿
demonstrate | vt. 表明，证明，展露
governor | n. 州长，省长
outline | n. 概要，梗概，概述，概括
soar | vi. 猛增
exotic | adj. 异国风情的，外来的
stride | n. 大步，进展，进步
intercourse | n. 性交
militant | adj. 好战的，激进的 | n. 好战分子
zigzag | n. 锯齿形线条 | adj. 之字形的 | vi. 曲折前进
alternate | vt. vi. （使）轮流，（使）交替
verse | n. 诗节
hoist | vt. 吊起，升起，提起 | n. 吊车，起重机
distinction | n. 差别，不同，卓越
stern | adj. 严厉的，苛刻的，难对付的
panorama | n. 全景，全景图
globe | n. 地球，世界
temptation | n. 引诱，诱惑，诱惑人的事物
toss | vt. 扔，掷，抛
terminal | n. 终端
soak | vt. vi. 浸泡，湿透
astonish | vt. 使吃惊，使惊讶
trail | n. 痕迹，踪迹，（乡间）小路，路线
striking | adj. 显著的，惊人的
legitimate | adj. 合法的，正当的
policy | n. 政策，保险单
politics | n. 政治
diffuse | vt. vi. 传播，散步 | vt. 舒缓，减弱，平息 | adj. 扩散的，分散的
prestige | n. 威信，声望
scorn | vt. 轻蔑，蔑视
dazzle | vt. vi. （强光）使目眩，使眼花
guilt | n. 内疚，悔恨
reputation | n. 名誉，名声
abide | vi. 遵守，遵从
magnitude | n. 巨大，重要性
preface | n. （书的）序言，前言，绪论
dubious | adj. 可疑的
suspend | vt. 暂停，中止
imitate | vt. （为逗乐）模仿，仿效，模拟
vessel | n. 舰，轮船，血管
regard | vt. 认为，看待
prevalent | adj. 流行的，盛行的，普遍的
franchise | n. 特许经营权，选举权 | vt. 出售（或授予）特许权
slice | n. 薄片，部分 | vt. 把...切成（薄）片
crew | n. 全体船员，机组人员，专业人员
deplete | vt. 大量削减，耗减
insulate | vt. 使隔热，使绝缘，使隔音
posture | n. 姿态，姿势
bond | n. 纽带 | vt. vi. （使）粘合，连结，增强信任
contrive | vt. 图谋，策划
comet | n. 彗星
cling | vi. 紧紧抓住
pace | n. 移动速度，步伐，节奏
appointment | n. 约定，预约，任命，指派
psychology | n. 心理学
predict | vt. 预言，预测，预告
composition | n. 构成，成分，构图，作品，作文
coincide | vi. 同时发生，（想法等）相同
formulate | vt. 规划，策划，构想，确切表达
acute | adj. 严重的，割裂的，敏锐的
steer | vt. 操纵，控制，引导
conclusion | n. 结论，推论，结束，结尾
oppress | vt. 压迫，欺压
principle | n. 原则，原理，定律
outcome | n. 结果，后果
liberal | adj. 开明的，（政治）自由的，通识的
contest | n. 比赛，竞赛 | vt. 争辩，提出异议，争取赢得
rejoice | vt. vi. 非常高兴，深感欣喜
specific | adj. 明确具体的，特定的 | n. 细节，详情
overcome | vt. 克服
chop | vt. 切碎，砍，劈，（大幅度的）削减
eliminate | vt. 消除，清除
prolong | vt. 延长，拖延
epoch | n. 时代，纪元
critic | n. 评论家，批评家，批评者
emergency | n. 紧急事件，意外事件
anxious | adj. 焦虑的，渴望的
ideal | adj. 理想的，最佳的 | n. 理想，理想典范，完美典型
constant | adj. 经常的，不断的，恒定的 | n. 不变的事物，常数，常量
testify | vt. vi. 证实，证明
assure | vt. 向...保证
glamor | n. 魅力，吸引力
substantial | adj. 大量的，重大的，实质性的
reporter | n. 记者
temporal | adj. 时间的，世俗的，太阳穴的
democratic | adj. 民主的
vivid | adj. 生动的，清晰的
domestic | adj. 国内的，家庭的
proposal | n. 提议，提案
devise | vt. 想出，发明，设计
interior | n. 内部，内政 | adj. 内部的
patriotic | adj. 爱国的
feudal | adj. 封建的，封建制度的
discard | vt. 抛弃，丢弃
entitle | vt. 给予...权利（或资格），给...提名
repertoire | n. 全部节目，曲目
drawback | n. 缺点，不利条件
recollect | vt. vi. 记起，回忆起
transistor | n. 晶体管
kneel | vi. 跪下，跪着
gorgeous | adj. 极其漂亮的，令人十分愉快的
collar | n. 衣领，领子
dictation | n. 口述，口授，听写（测试）
bolster | vt. 加强，改善
decent | adj. 像样的，得体的
tune | n. 曲调，曲子
readily | adj. 轻而易举地，乐意地，欣然地
quiver | vi. 颤抖，哆嗦 | n. 箭袋，箭筒
auction | n. 拍卖
enthusiasm | n. 热爱，热情，热衷的活动
lid | n. 盖，盖子
shaft | n. 电梯井，杆，一束 | vt. 亏待，欺骗
consult | vt. vi. 向...咨询，求教
sympathy | n. 同情，支持，赞同
receipt | n. 收据
bulk | n. 大部分，大体积，大量
correspondence | n. 往来书信，通信
isle | n. （常用于地名）岛
entail | vt. 牵涉，涉及，需要
savage | adj. 凶恶的 | n. 野蛮人
meditation | n. 冥想，默想
proceeding | n. （会议）记录
propose | vt. 提议，打算
illustration | n. 插图，绘图，实例
primitive | adj. 原始的，落后的
decree | n. 法令，政令 | vt. vi. 判决，颁布
commit | vt. 犯（错或罪），承诺
knob | n. 旋钮，球形把手，疙瘩，小块
hypothesis | n. 假说，假设
agenda | n. 议事日程，待办事项，隐秘意图
alliance | n. 联合，结盟，结盟团体，联盟
burst | vi. 爆满，涨满，突然爆发 | n. 迸发，爆发
couple | n. 两个，几个，（一对）夫妻，情侣 | vt. 结合，将...与...联系起来
departure | n. 离开，出发，出发班次
reclaim | vt. 取回，收回
skyscraper | n. 摩天大楼
cab | n. 出租车
irony | n. 有讽刺意味的情况
gum | n. 口香糖，牙龈，牙床
stagnant | adj. （水或空气）不流动的，停滞的
colleague | n. 同事，同僚
decisive | adj. 决定性的，关键的，果断地
fascinate | vt. vi. 使着迷，迷住
thoughtful | adj. 沉思的，深思熟虑的
jury | n. 陪审团，裁判委员会
contempt | n. 鄙视，蔑视
diminish | vt. vi. 减少，降低，减弱 | vt. 贬低，轻视
association | n. 协会，社团，联系，关联，联想
complain | vt. vi. 抱怨，投诉，发牢骚
physician | n. （内科）医生
distinguish | vt. vi. 区分，辨别，分清 | vt. 使有别于，使表现突出
peer | n. 同龄人，同辈 | vi. 端详，费力地看
vice | n. 恶习 | pref. 副的，次的
commend | vt. 赞扬
deduce | vt. 推断，推理，演绎
deteriorate | vi. 恶化，变坏，衰退
forge | vt. 缔造，建立
academy | n. 学院，学会，研究院
safeguard | vt. vi. 保护，保障，捍卫 | n. 安全设施，保护措施
sue | vt. vi. 控告，起诉
casualty | n. 受害者
overwhelm | vt. 使不知所措，压垮
patent | n. 专利权 | vt. 得到...的专利权
huddle | vi. 挤在一起，缩成一团 | n. 拥挤的一群，杂乱的一堆
incline | vt. vi. （使）倾向
preceding | adj. 前面的，在先的
optimum | adj. 最佳的，最适宜的 | n. 最佳条件，最佳水平
attend | vt. vi. 出席，参加 | vt. 去（学校等） | vi. 注意，专心
prospective | adj. 潜在的，可能发生的，预期的
trivial | adj. 琐碎的，微不足道的
underestimate | vt. 低估，轻视 | n. 低估，轻视
implication | n. 可能的影响，暗示，含意
stipulate | vt. 规定，约定，明确要求
illustrate | vt. 说明，阐明
appoint | vt. 任命，指派
appliance | n. （家用）电器，装置
railroad | n. 铁路（系统），铁路公司 | vt. 迫使...仓促行事
revise | vt. 改变（想法），修改，修订
contrast | n. 差异，差别 | vt. 对照，对比 | vi. 截然不同，有明显差异
embrace | vt. 欣然接受，包括
hamper | vt. 妨碍，阻碍
corporation | n. 大公司，大企业
committee | n. 委员会
statesman | n. 政治家
likelihood | n. 可能性，可能的事
practitioner | n. 从业人员
discharge | vt. 准许离开，解雇 | vt. vi. 排放，排出
riot | n. 暴乱，丰富多彩 | vi. （人群）发生骚乱，闹事
permission | n. 许可（证），批准
battery | n. 电池，一系列，一批
exhibit | vt. vi. 展览，展出，表现出，显示出 | n. 展品
shorthand | n. 速记法
tanker | n. 油轮，油罐车
multitude | n. 众多，大量
botany | n. 植物学
gaze | vi. 注视，凝视 | n. 注视，凝视
sculpture | n. 雕刻作品，雕像
repression | n. 压制，镇压，抑制，克制
minor | adj. 较小的，次要的，轻微的
cashier | n. 出纳员，收银员 | vt. 开除，革除（军职）
swallow | vt. 信以为真
sail | vi. 起航
empire | n. 帝国
drought | n. 干旱，旱灾
drastic | adj. （变化）急剧的
hence | adv. 因此，由此，以后
inhale | vt. vi. 吸气，吸入
chunk | n. 大量，大部分
shepherd | n. 牧羊人 | vt. 带领，护送
persist | vt. vi. 顽强坚持，执着 | vi. 持续，延续
courage | n. 勇气，胆量，勇敢
draft | n. 草稿 | vt. 起草，草拟
tissue | n. （动植物的）组织
marble | n. 大理石，弹珠，弹子游戏
sorrow | n. 悲伤，伤心，令人悲伤的事 | vi. 感到悲伤
induce | vt. 引起，导致
fume | vt. vi. （因...）恼火，生气 | n. （有害、难闻的）气体，烟雾
obstruct | vt. 阻挠，妨碍
recede | vi. 渐渐远离，减弱，（发际线）后移
compact | n. 协定，契约
permeate | vt. vi. （感情等）充斥
rib | n. 肋骨，排骨 | vt. （友善地）开...的玩笑
aerial | adj. 从飞机上的
ascend | vt. vi. 上升，攀登
retrieve | vt. 检索数据
stroll | vi. 散步，溜达，闲逛
vanity | n. 自负，虚荣
commemorate | vt. （用...）纪念，作为...的纪念
intervene | vi. 干涉，介入
brass | n. 黄铜，铜管乐器，要员
kidney | n. 肾脏，腰子
germ | n. 细菌，病菌，起源，萌芽，胚胎
fragment | n. 碎片，片段，小部分 | vt. vi. （使）成碎片，（使）分裂
handful | n. 少数
boycott | vt. 抵制
depart | vt. vi. 离开，启程，离职 | vi. 背离，违背
obscure | adj. 鲜为人知的，难以理解的 | vt. 掩盖，使模糊，使隐晦
criticism | n. 批评，指责，（对书等的）评论
brevity | n. 简洁，短暂
verdict | n. 裁决，裁定，意见，决定
offspring | n. 子女，后代
indicate | vt. 表明，暗示
detach | vt. vi. （使）分开，脱离，拆卸 | vt. 摆脱，离开
endeavor | vi. 努力，尽力 | n. 努力，尝试
precedent | n. 可援引的例子
liable | adj. 可能做...的，有责任的，易遭受...
formidable | adj. 令人敬畏的，难对付的
periodical | n. （尤指学术）期刊
perplex | vt. 使困惑，使茫然
board | n. 董事会
pierce | vt. vi. 刺入
scenery | n. 风景，景色
underlying | adj. 深层的，潜在的
collide | vi. 碰撞，相撞
universal | adj. 普遍的，全体的，共同的 | n. 普遍看法，普遍特征
identical | adj. 完全相同的，同样的
ideology | n. 思想体系，意识形态
temper | n. 脾气 | vt. 使缓和
restore | vt. 恢复
reserve | vt. 预留 | n. 储备（量），自然保护区
assurance | n. 把握
thorough | adj. 全面的，彻底的
architect | n. 建筑师
refusal | n. 拒绝，回绝，不接受
submerge | vt. vi. （使）浸没，淹没，没入水中
spectacle | n. 眼镜，奇特的现象
palm | n. 手掌，手心
fatigue | n. 疲惫，疲倦
course | n. 课程，航线，菜，进程
elbow | vt. 用肘推
rope | n. 粗绳，线缆
inherit | vt. vi. 继承 | vt. 经遗传获得
litter | vt. 使乱七八糟
hose | n. 软管，胶管，（旧时）男式紧身裤 | vt. 用软管洒水、清洗等
moist | adj. 湿润的，潮湿的
vacant | adj. 空的，（职位）空缺的
acquaint | vt. 使熟悉，使了解
solidarity | n. 团结一致，相互支持
minority | n. 少数，少数民族，少数群体
vapor | n. 蒸气，水汽
divine | adj. 天赐的，神的，绝妙的，极棒的 | vt. 猜测，揣度 | vt. vi. （用探测棒）探测
antique | n. 古董，古玩
nuisance | n. 讨厌的人，麻烦的事，非法妨害
criterion | n. 标准，准则
burglar | n. 破门盗窃者，窃贼
adjacent | adj. 邻近的，毗连的
peninsula | n. 半岛
remarkable | adj. 非凡的，不同寻常的
retrospect | n. 回顾，回想
feminine | adj. 女性的，女性化的，阴性的
renaissance | n. 文艺复兴（时期），重新流行
deploy | vt. 有效运用，利用
oar | n. 船桨，桨
overt | adj. 公开的，明显的
rouse | vt. 唤醒，叫醒，使...活跃，激发
grace | n. 风度
grocer | n. 食品杂货商，食物杂货店
conspiracy | n. 密谋，阴谋
threshold | n. 门槛，起始点，临界点
pastime | n. 消遣，娱乐
notorious | adj. 臭名昭著的，声名狼藉的
civil | adj. 公民的，国内的，民用的
intrigue | vt. 激起...的兴趣，引起...的好奇 | vi. 密谋，施诡计 | n. 密谋，阴谋，引人入胜的特质
reassure | vt. 使安心，使消除疑虑
remnant | n. 残余部分
troop | n. 军队，部队
pension | n. 养老金
ivory | n. 象牙，象牙色，钢琴键
appetite | n. 胃口，食欲，强烈欲望，渴望
shutter | n. 快门
metric | adj. 米制的，公制的 | n. 度量工具，衡量指标
liquor | n. 酒精类饮料，烈性酒
acquire | vt. 获得（技能、习惯等），购得，得到
deprive | vt. 剥夺，使不能拥有
controversial | adj. 有争议的，引发争论的
immense | adj. 巨大的，极大的
emerge | vi. 出现，浮现，开始为人所知，（从困境中）摆脱出来
render | vt. 使变得，给予，提供，表达
concise | adj. 简洁的，简明的
endorse | vt. 公开支持
politician | n. 从政者，政治家
straightforward | adj. 简单易懂的
reliance | n. 依赖，依靠
admission | n. 准许加入，承认，招认
imitation | n. 模仿，效仿
debate | n. 辩论，讨论，争论 | vt. vi. 辩论，讨论，争论
affair | n. 事务，事情，暧昧关系
affection | n. 喜爱，钟爱
formation | n. 形成，产生，编队
specialist | n. 专家
sequence | n. 一系列，一连串，顺序，次序 | vt. 测定...的序列
ceremony | n. 仪式，典礼
comprehensive | adj. 全面的，综合性的
essence | n. 本质，精髓
celebrity | n. 名人，明星
pour | vt. vi. 下大雨 | vi. （液体、烟等）涌流
arise | vi. 发生，出现，由...引起
remains | n. 残余，剩余物，遗迹
constituent | n. 成分，选民
extinguish | vi. 熄灭，扑灭
consequently | adv. 结果，因此，所以
conflict | n. 冲突，争执 | vi. 相互矛盾，冲突
cognitive | adj. 认知的，感知的，认识的
frank | adj. 坦率的，直率的
ozone | n. 臭氧
intermediate | adj. 中级的，居中的 | n. 中级水平者
facilitate | vt. 促进，使便利
slam | vt. vi. （使...）砰地关上 | vt. 用力一放，使劲一推，猛烈抨击 | n. 猛关（或推、摔、撞等）的声音
unanimous | adj. 一致通过的
edible | adj. 可食用的，能吃的 | n. 食品
coronavirus | n. 冠状病毒
duplicate | vt. 复制，复印
satire | n. 讽刺，讽刺作品
liner | n. 邮轮，客轮，内衬
adhere | vi. 遵循（规章等）
excerpt | n. 摘录，节选片段 | vt. 摘录，节选
envisage | vt. 设想，展望
orientation | n. 方向，定位，取向
eccentric | adj. 古怪的，怪异的，行为古怪的人
strife | n. 冲突，纠纷，纷争
inward | adj. 内心的，内在的，向内的 | adv. 向内地，向内心地
lest | conj. 唯恐，以免
thermometer | n. 温度计
colonial | adj. 殖民地的，殖民地时期的
tangle | vt. vi. （使）缠结在一起，（使）乱成一团 | n. 缠结的一团，混乱，纷乱
screw | n. 螺丝，螺丝钉
prophet | n. 预言家
grease | n. 动物油脂，润滑油，（皮肤）油脂 | vt. 在...上涂油
scout | n. 童子军，侦查员，侦察机 | vt. vi. 侦察，搜寻（某处），物色
manufacture | vt. 大量制造，编造
majesty | n. 雄伟壮观，庄严，（尊称）陛下
saucer | n. 茶碟，茶托
clarity | n. （思路，图像）清晰
stationary | adj. 静止的
exceedingly | adv. 极其，非常
abdomen | n. 腹部
stereotype | n. 成见，刻板印象 | vt. 对...有成见
pint | n. 品脱，一品脱啤酒
daunting | adj. 使人气馁的，吓人的
hygiene | n. 卫生，保健
slump | n. 暴跌
marine | adj. 海洋的，海产的
dawn | n. 开端，起始阶段
pad | vt. （用软材料）填充，覆盖
torrent | n. 急流，湍流，迸发，狂潮
overhead | n. 经营开支
hysterical | adj. 歇斯底里的，极其可笑的
henceforth | adv. 从今以后，从现在起
carriage | n. 马车，火车车厢，运费，仪态
stagnate | vi. 停滞不前，使萧条
barn | n. 谷仓，畜棚
spectator | n. 观众
chamber | n. 房间，议院
opt | vt. vi. 选择，作出抉择
climax | n. 高潮，顶点 | vt. vi. 达到顶点（或高潮）
veteran | n. 有经验的人，老手，退伍军人
plunge | vt. vi. （使）突然前冲（或下落） | n. 暴跌
fare | n. 车费，票价
inverse | adj. 成反比的，相反的 | n. 与...相反的事物，对立面
coalition | n. 联合政府，联合体，联盟
prone | adj. 有...倾向的
ritual | n. 仪式，惯例，老规矩 | adj. 仪式的
contagious | adj. 接触性传染的，有感染力的
elevate | vt. 提拔，提升，提高，鼓舞
contingent | adj. 依情况而定的
bowel | n. 肠胃
circulate | vt. vi. 循环，流通，散布 | vt. 传递，传阅 | vi. （在聚会上）往来应酬
latent | adj. 潜在的，潜藏的
odds | n. 几率，可能性
spacious | adj. 广阔的，宽敞的
parade | n. （庆祝）游行
spine | n. 脊椎，刺，棘，书脊，骨气
forth | adv. （从某时）往前，（从某处）向外
spite | n. 怨恨，恶意 | vt. 故意伤害，激怒
missile | n. 导弹，飞弹，（作为武器）投掷物
sheer | adj. ...之重，之大
vein | n. 静脉，叶脉，矿展，风格，方式
scrape | vt. vi. 艰难取得
loyal | adj. 忠诚的，忠心的
mobilize | vi. 调动，调用
contemplate | vt. 打算，考虑，沉思
insist | vt. vi. 坚持，坚决要求，坚称
smog | n. 雾霾，烟雾
sentiment | n. 情绪，观点
outing | n. 远足，短途旅行
nominal | adj. 名义上的，象征性的，很少的
plagiarism | n. 剽窃（作品）
ascribe | vt. 将...归因于，认为是...的特点
reinforce | vt. 加强，增强
mount | vt. 安排，组织开展 | n. 山峰
articulate | vt. 清楚的表达
tilt | vt. vi. （使）倾斜，使倾向于，偏向 | n. 倾斜，倾侧
infant | n. 婴儿 | adj. 供婴幼儿用的
lane | n. 车道，航线
pilgrim | n. 朝圣者，清教徒前辈移民
census | n. 官方统计，人口普查
owing | adj. 未偿还的，欠着的
merchandise | n. 商品，货品 | vt. 推销，（运用广告等进行）销售
excursion | n. （集体）短途旅游，涉足，涉猎
longitude | n. 经度
bitter | adj. 使人悲痛的，苦的，严寒的
residence | n. 住处，住宅，居住
intermittent | adj. 间歇的，断断续续的
doctrine | n. 信条，主义，教义
persecute | vt. 迫害，残害，压迫，骚扰，打扰
reproach | n. 责备，批评，丢脸 | vt. 责备，为...感到内疚
boundary | n. 分界线，边界
bound | adj. 肯定会的，受约束的，前往...的
glorious | adj. 壮丽的
navy | n. 海军
assign | vt. 分配，分派，指派，为...设定
pedestrian | n. 行人，步行者
dial | vt. vi. 拨号 | n. 表盘，刻度盘，仪表盘
interface | n. 交互页面
orient | vt. 使朝向，针对
artifact | n. 人工制品，手工艺品
consent | n. 许可，准许，同意 | vi. 许可，准许，同意
cloak | vt. 遮盖，掩盖
arrange | vt. vi. 安排，筹备 | vt. 整理，排列，布置
nominate | vt. 提名，任命，指定
lubricate | vt. 给...上润滑油，上油
accountant | n. 会计，会计师
generous | adj. 慷慨的，大量的
scheme | n. 计划，方案
constrain | vt. 限制，约束
bias | n. 偏见，偏袒 | vt. 使有偏见，使偏心
sophisticated | adj. 精密的，复杂的
anticipate | vt. 预料
thrill | n. 兴奋感，激动
federal | adj. 联邦政府的
arouse | vt. 引起，激起，激发
indication | n. 表明，迹象，象征
thrive | vi. 兴旺，繁荣，欣欣向荣
breach | n. 违背，破坏
grim | adj. 严肃的，令人沮丧的，阴森的
claim | vt. 声称，要求拥有，认领，获得 | n. 声称，所有权
promote | vt. 促进，推销，晋升，提倡
fabricate | vt. 捏造，编造，制造，生产
promising | adj. 大有希望的，很有前途的
lucrative | adj. 获利多的，赚钱的
monetary | adj. 货币的，金融的
versatile | adj. （人）多才多艺的，多功能的
mechanism | n. 方法，途径，机制
parcel | n. 包裹，邮包
curve | n. 曲线，弧线 | vt. vi. （使）弯曲，（使）成曲线
approximate | adj. 大约的，大致的 | vt. vi. 近似，与...基本一致 | vt. 粗略估计，近似计算
fetch | vt. 去拿，去取，去接，售得
disposition | n. 性情，倾向
oblige | vt. （因法律或义务）强迫，迫使 | vt. vi. 帮忙，效劳
assimilate | vt. vi. （使）同化，融入
situate | vt. 使坐落于，使位于，将...置于
evident | adj. 明显的，显然的
elegant | adj. 优雅的，雅致的
ethic | n. 伦理，道德体系，伦理学
succession | n. 一连串，继承，继承权
boast | vt. vi. 自吹自擂，自夸
interpret | vt. 解释，说明，把...解释为
precious | adj. 珍贵的，珍稀的
operational | adj. 运营的
dividend | n. 红利，股息
transfer | vt. vi. 转移，调动 | n. 转移，调动
elaborate | adj. 复杂的，详尽的，精心制作的 | vt. vi. 详尽说明，详尽阐述
vegetation | n. 植被，植物，草木
scatter | vt. vi. （使）散开，（使）散布在各处
cloth | n. 布，布料
motive | n. （行动的）动机，缘由
creep | vi. 渐渐出现
dilemma | n. （进退两难的）窘境
via | prep. 通过，凭借
thick | adj. 厚的，粗的，浓密的
beware | vt. vi. 当心，提防
cargo | n. （轮船，飞机所装载的）货物
register | vt. vi. 注册，登记，显示（读数），记录 | n. 登记表，现金收纳机
discrete | adj. 分开的，分离的，各自的
assignment | n. 作业，任务
salvation | n. 救赎，救助途径
synthesis | n. 合成
discrepancy | n. 差异，不符合
magistrate | n. 地方执法官
conquer | vt. 占领，征服，克服
compulsory | adj. 强制性的，义务的
shiver | vi. 哆嗦，发抖 | n. 寒战，颤抖
resolute | adj. 坚决的，坚定的，果断的